88.46
1111111111111111111111111111111111111111111111111111111111111111111111111111111111111111
1000000000000000000000000000000000000000000000000000000000000000000000000000000000000001
1000000000000000000000000000000000000000000000000000000000000000000000000000040000000001
1000000000000000000000000000000000000000000000000000000000000000000000000000000000000001
1000000000000000000000000000000000000000000000000000000000000000000000000000000000000001
1000000000000000000000000000000000000000000000000000000000000000000000000000000000000001
1000000000000000000000000000000000000000000000000000000000000000000000000000000000000001
1000000000000000000000000000000000000000000000000000000000000000000000000000000000000001
1000000000000000000000000000000000000000000000000000000000000000000000000000000000000001
1000000000000000000000000000000000000000000000000000000000000000000000000000000000000001
1000000000000000000000000000000000000000000000000000000000000000000000000000000000000001
1000000000000000000000000000000000000000000000000000000000000000000000000000000000000001
1000000000000000000000000000000000000000000000000000000000000000000000000000000000000001
1000000000000000000000000000000000000000000000000000000000000000000000000000000000000001
1000000000000000000000000000000000000000000000000000000000000000000000000000000000000001
1000000000000000000000000000000000000000000000000000000000000000000000000000000000000001
1000000000000000000000000000000000000000000000000000000000000000000000000000000000000001
1000000000000000000000000000000000000000000000000000000000000000000000000000000000000001
1000000000000000000000000000000000000000000000000000000000000000000000000000000000000001
1000000000000000000000000000000000000000000000000000000000000000000000000000000000000001
1000000000000000000000000000000000000000000000000000000000000000000000000000000000000001
1000000000000000000000000000000000000000000000000000000000000000000000000000000000000001
1000000000000000000000000000000000000000000000000000000000000000000000000000000000000001
1000000000000000000000000000000000000000000000000000000000000000000000000000000000000001
1000000000000000000000000000000000000000000000000000000000000000000000000000000000000001
1000000000000000000000000000000000000000000000000000000000000000000000000000000000000001
1000000000000000000000000000000000000000000000000000000000000000000000000000000000000001
1000000000000000000000000000000000000000000000000000000000000000000000000000000000000001
1000000000000000000000000000000000000000000000000000000000000000000000000000000000000001
1000000000000000000000000000000000000000000000000000000000000000000000000000000000000001
1004000000000000000000000000000000000000000000000000000000000000000000000000000000000001
3233333333333333333333300000000000000000000000000000000000000000000000000000000000000001
3200000000000000000000300000000000000000000000000000000000000000000000000000000000000001
3200000000000000000020300000000000000000000000000000000000000000000000000000000000000001
3333333333333333333320300000000000000000000000050000000000000000000000000000000000000001
3000000000000000000020300000000000000000000000000000000000000000000000000000000000000001
3000000000000000000020300000000000000000000000000000000000000000000000000000000000000001
3000000000000000000020300000000000000000000000000000000000000000000000000000000000000001
3000000000000000000020300000000000000000000000000000000000000000000000000000000000000001
3220000000000000000020300000000000000000000000000000000000000000000000000000000000000001
3223333333333333333333300000000000000000000000000000000000000000000000000000000000000001
3220000000000000000000300000000000000000000000000000000000000000000000000000000000000001
3220000000000000000000300000000000000000000000000000000000000000000000000000000000000001
3220000000000000000000000000000000000000000000000000000000000000000000000000000000000001
3220000000000000000000000000000040000000000000000000000000000000000000000000040000000001
3333333333333333333333311111111111111111111111111111111111111111111111111111111111111111