88.46
1111111111111111111111111111111111111111111111111111111111111111111111111111111111111111
1000000000000000000000000000000000000000000000000000000000000000000000000000000000000001
1000000000000000000000000000000000000000000000000000000000000000000000000000000000000001
1000000000000000000000000000000000000000000000000000000000000000000000000000000000000001
1000000000000000000000000000000000000000000000000000000000000000000000000000000000000001
1000000000000000000000000000000000000000000000000000000000000000000000000000000000000001
1000000000000000000000000000000000000000000000000000000000000000000000000000000000000001
1000000000000000000000000000000000000000000000000000000000000000000000000000000000000001
1000000000000000000000000000000000000000000000000000000000000000000000000000000000000001
1000000000000000000000000000000000000000000000000000000000000000000000000000000000000001
1000000000000000000000000000000000000000000000000000000000000000000000000000000000000001
1000000000000000000000000000000000000000000000000000000000000000000000000000000000000001
1000000000000000000000000000000000000000000000000000000000000000000000000000000000000001
1000000000000000000000000000000000000000000000000000000000000000000000000000000000000001
1000000000000000000000000000000000000000000000000000000000000000000000000000000000000001
1000000000000000000000000000000000000000000000000000000000000000000000000000000000000001
1000000000000000000000000000000000000000000000000000000000000000000000000000000000000001
1000000000000000000000000000000000000000000000000000000000000000000000000000000000000001
1000000000000000000000000000000000000000000000000000000000000000000000000000000000000001
1000000000000000000000000000000000000000000000000000000000000000000000000000000000000001
1000000000000000000000000000000000000000000000000000000000000000000000000000000000000001
1000000000000000000000000000000000000000000000000000000000000000000000000000000000000001
1000000000000000000000000000000000000000000000000000000000000000000000000000000000000001
1000000000000000000000000000000000000000000000000000000000000000000000000000000000000001
1000000000000000000000000000000000000000000000000000000000000000000000000000000000000001
1000000000000000000000000000000000000000000000000000000000000000000000000000000000000001
1000000000000000000000000000000000000000000000011111111111111000000000000000000000000001
1000000000000000000000000000000000000000000000000000000000000000000000000000000000000001
1000000000000000000000000000000000000000000000000000000000000000000000000000000000000001
1000000000000000000000000000000000000000000000000000000000000000000000000000000000000001
1000000000000000000000000000000000000000000000000000000000000000000000000000000000000001
3333333333333333333333300000000000000000000000000000000000000000000000000000000000000001
3000000000000000000000300000000000000000000000000000000000000000000000000000000000000001
3000000000000000000020300000000000000000000000000000000000000000000000000000000000000001
3333333333333333333320300000000000000000000000000000000000000000000000000000000000000001
3000000000000000000020300000000000000000000000000000000000000000000000000000000000000001
3000000000000000000020300000000000000000000000000000000000000000000000000000000000000001
3000000000000000000020300000000000000000000000000000000000000000000000000000000000000001
3000000000000000000020300000000000000000000000000000000000000000000000000000000000000001
3220000000000000000020300000000000000000000000000000000000000000000000000000000000000001
3223333333333333333333300000000000000000000000000200000000000000000000000000000000000001
3220000000000000000000300000000000000000000000000300000000000000000000000000000000000001
3220000000000000000000300000000000000000000000000100000000000000000000000000000000000001
3220000000000000000000000000000000000000000000002300000000000000000000000000000000000001
3220000000000000000000000000000000000000000000002200000000000000000000000000000000000001
3333333333333333333333311111111111111111111111111111111111111111111111111111111111111111